14
9 9 9 9 9 9 9 4 6 9
9 9 4 9 9 9 9 9 9 9
9 0 9 9 4 9 9 9 9 9
9 9 9 9 9 6 9 9 9 9
9 9 9 9 9 6 9 9 4 9
9 9 9 9 9 9 9 9 9 6
9 9 6 9 9 4 9 9 9 9
9 9 9 9 9 9 9 9 9 1
9 9 4 6 9 6 9 9 9 9