7
9 9 9 9 9 9 9 9 9 9
7 0 9 9 9 9 9 9 9 9
9 9 9 9 9 9 9 9 9 9
9 7 7 9 9 9 9 9 9 9
9 9 9 4 9 8 9 9 7 9
9 9 9 9 9 9 9 9 9 9
9 9 9 9 9 9 9 9 9 4
9 9 9 6 9 9 8 9 9 7
9 9 9 9 9 9 6 9 6 9
9 9 9 9 9 9 9 9 9 1