4
9 9 9 9 9 9 9 9
9 0 3 4 9 9 9 9
9 4 3 9 9 9 9 9
9 9 3 9 6 6 9 9
9 9 4 9 3 3 4 9
9 3 3 9 9 9 1 9
9 9 6 9 9 9 9 9
9 9 9 9 6 9 9 9