20
9,9,9,3,9,5,0,9
9,9,9,3,6,9,9,9
9,9,9,3,1,9,9,9
9,9,4,3,3,3,5,6
8,2,7,9,8,9,9,9
9,9,9,9,9,5,9,9
9,9,9,5,9,9,9,9
9,9,9,9,5,9,5,9