12
9 9 9 9 9 9 9 9
9 9 9 0 9 9 9 9
9 9 4 3 9 9 9 9
9 9 9 3 6 9 9 9
9 9 3 3 3 9 9 9
4 9 9 9 3 9 4 9
9 9 3 3 9 9 1 9
6 3 3 6 9 4 9 9