17
9 9 9 9 9 9 9 9
3 9 3 3 3 9 6 9
3 9 9 9 9 9 9 9
3 9 4 9 3 4 1 9
4 0 9 9 3 9 9 9
9 9 9 4 3 9 9 9
9 9 9 6 9 9 4 3
6 6 6 6 9 9 3 6