18
9 6 9 9 9 9 9 9 9 9
9 9 4 9 4 4 9 9 9 9
9 0 9 4 9 9 9 9 9 6
9 6 9 9 9 9 9 9 9 9
9 9 9 9 9 6 9 9 9 9
9 6 9 9 9 9 9 9 9 9
9 9 9 4 4 4 4 9 9 9
9 9 9 4 9 9 9 6 9 4
9 9 4 9 9 9 9 9 6 1
9 9 9 9 9 9 9 6 9 4