26
9 9 6 9 4 9 0 4 9 9
9 9 6 9 9 9 3 3 3 9
9 9 4 6 6 7 3 3 6 9
4 9 9 3 3 3 3 4 9 4
4 8 3 3 9 9 4 9 9 9
9 9 3 7 9 7 9 7 9 4
4 9 9 9 6 6 9 9 9 9
9 9 6 3 3 3 3 3 3 9
9 9 9 3 3 6 3 4 8 4
9 9 9 6 6 1 9 9 4 4