9
9 6 9 9 2 3 5 9
9 9 9 6 9 3 9 9
9 0 9 9 4 3 2 6
9 9 4 2 9 9 5 9
9 9 5 4 9 3 9 9
9 2 9 5 3 3 1 6
9 9 9 9 9 3 5 9
9 5 9 9 9 9 9 9