12
9 9 9 9 9 9 9 9
4 4 4 9 9 9 9 9
0 9 9 9 6 9 9 9
9 9 9 9 6 9 9 9
9 9 6 9 9 6 9 9
9 6 9 9 9 9 1 9
9 9 9 9 9 9 9 9
9 9 9 9 6 6 6 9