35
9 9 9 9 7 9 9 9 9 9
5 9 9 5 0 2 3 9 9 9
5 9 9 9 9 3 3 9 9 9
6 9 9 9 9 9 3 3 9 9
3 9 9 8 8 6 9 9 9 9
3 4 3 2 2 2 3 3 9 9
8 9 8 9 9 5 8 9 9 9
9 9 4 9 7 5 9 9 9 9
9 5 5 9 9 3 3 1 6 9
9 9 9 9 3 3 9 4 9 9