22
5 5 9 9 6 4 8 9 9 9
2 0 9 7 5 9 9 9 9 9
3 3 3 6 6 5 9 9 9 2
2 6 3 3 3 3 9 9 9 2
9 9 4 9 9 3 7 9 9 9
5 9 9 5 5 9 9 4 3 9
3 3 9 2 3 3 3 3 3 9
2 3 9 7 5 9 4 9 6 9
9 3 3 3 9 9 8 5 9 9
6 9 6 9 7 9 4 9 1 9