10
9 9 9 9 9 9 9 9
6 9 9 9 9 9 9 9
9 9 9 9 9 4 9 9
0 9 7 9 7 9 7 9
9 9 9 9 9 9 9 1
9 8 9 4 9 9 8 4
9 9 6 9 9 9 6 9
9 9 9 9 9 9 9 9
