9,9,8,9,9,7,9,9
9,9,9,9,9,9,9,9
9,9,9,9,9,9,9,9
9,9,9,9,9,9,9,9
9,9,9,8,7,9,9,9
5,9,9,9,5,9,9,9
9,9,7,9,9,7,9,9
9,9,9,9,9,9,9,9