8
9 4 9 9 9 9
9 0 9 9 9 9
4 9 4 9 9 9
9 4 9 9 9 9
9 9 4 4 1 4
9 9 9 9 9 9