Level 0
6 x 6
9 9 9 9 9 9
9 0 4 9 9 9 
9 9 9 9 9 9
9 4 9 9 9 9
9 9 4 9 1 9
9 9 9 9 9 9

ideal 3 max 4


Level 1
8 x 8
9 9 6 9 9 9 9 9
0 9 9 9 9 9 9 9
9 9 9 9 9 9 4 9
9 9 9 4 4 9 9 9
9 6 9 9 9 9 9 9
9 9 9 9 9 9 9 1
9 9 9 9 9 9 9 9
9 9 9 9 9 6 9 9

ideal 6 max 7

Level 2
8 x 8
9 9 9 9 9 9 9 9
9 0 3 4 9 9 9 9
9 4 3 9 9 9 9 9
9 9 3 9 6 6 9 9
9 9 4 9 3 3 4 9 
9 3 3 9 9 9 1 9
9 9 6 9 9 9 9 9
9 9 9 9 6 9 9 9

ideal 6 max 7

Level 3
8 x 8
9 9 9 9 9 9 9 9
9 9 9 0 9 9 9 9
9 9 4 3 9 9 9 9
9 9 9 3 6 9 9 9
9 9 3 3 3 9 9 9
4 9 9 9 3 9 4 9 
9 9 3 3 9 9 1 9
6 3 3 6 9 4 9 9

ideal 10 max 12


Level 4
10 x 10
9 9 9 9 9 9 9 4 6 9
9 9 4 9 9 9 9 9 9 9 
9 0 9 9 4 9 9 9 9 9
9 9 9 9 9 6 9 9 9 9
9 9 9 9 9 6 9 9 4 9
9 9 9 9 9 9 9 9 9 6
9 9 6 9 9 4 9 9 9 9 
9 9 9 9 9 9 9 9 9 1
9 9 4 6 9 6 9 9 9 9

ideal 11 max 14


Level 5
10 x 10
9 9 9 9 9 9 9 9 9 9
9 9 9 9 9 9 9 9 9 9
6 9 9 9 9 9 9 9 6 9
3 3 4 9 9 6 9 9 9 9
0 3 9 3 9 3 3 9 4 9
9 4 3 3 9 3 6 4 9 1
9 9 3 3 9 3 9 3 6 9
9 9 9 6 4 9 3 3 3 9
9 9 9 9 9 9 9 9 9 9
9 9 9 9 9 9 9 9 9 9

ideal 11 max 13

Level 6
10 x 10
9 9 9 9 9 9 9 9 9 9
9 9 9 9 9 9 9 9 9 9
9 9 9 9 9 9 9 9 9 9
0 7 9 9 9 9 9 9 9 9
9 9 9 9 9 7 9 9 7 9
9 9 9 9 9 9 4 9 1 9
9 9 8 9 9 4 9 9 9 9
9 9 9 6 9 9 9 9 9 9
9 9 9 9 9 9 9 9 9 9
9 9 9 9 9 9 9 9 9 9

ideal 4 max 4


Level 7
10 x 10
9 9 9 9 9 9 9 9 9 9
7 0 9 9 9 9 9 9 9 9
9 9 9 9 9 9 9 9 9 9
9 7 7 9 9 9 9 9 9 9 
9 9 9 4 9 8 9 9 7 9
9 9 9 9 9 9 9 9 9 9
9 9 9 9 9 9 9 9 9 4
9 9 9 6 9 9 8 9 9 7
9 9 9 9 9 9 6 9 6 9
9 9 9 9 9 9 9 9 9 1

ideal 5 max 7


Level 8
10 x 10
9 9 6 9 9 9 0 9 9 9
9 9 6 9 9 9 3 3 3 9 
9 9 4 9 6 7 3 3 4 9
9 9 9 3 3 3 3 6 9 4
4 8 3 3 9 9 4 9 9 9
9 9 3 7 9 7 9 7 9 4
9 9 9 9 9 9 9 9 9 9
9 9 9 3 3 3 3 3 3 9 
9 9 9 3 3 6 3 9 8 4
9 9 9 9 6 1 9 9 4 9

ideal 12 max 14