Level 0
6 x 6
9 4 9 9 9 9
9 0 9 9 9 9
4 9 4 9 9 9
9 4 9 9 9 9
9 9 4 4 1 4
9 9 9 9 9 9

ideal 6, max 8


Level 1
8 x 8
9 9 9 9 9 9 9 9
4 4 4 9 9 9 9 9
0 9 9 9 6 9 9 9
9 9 9 9 6 9 9 9
9 9 6 9 9 6 9 9
9 6 9 9 9 9 1 9
9 9 9 9 9 9 9 9
9 9 9 9 6 6 6 9

ideal 10, max 12

Level 2
8 x 8
9 9 9 9 9 9 9 9
3 9 3 3 3 9 6 9
3 9 9 9 9 9 9 9
3 9 4 9 3 4 1 9
4 0 9 9 3 9 9 9
9 9 9 4 3 9 9 9
9 9 9 6 9 9 4 3
6 6 6 6 9 9 3 6

ideal 14, max 17

Level 3
8 x 8
9 9 4 4 9 9 9 9
9 9 9 0 9 9 9 9
6 9 4 3 9 9 9 9
6 9 9 3 6 9 9 9
9 9 3 3 3 9 9 9
4 9 9 9 3 9 4 9
9 9 3 3 9 9 1 9
6 6 3 6 9 4 4 9

ideal 16, max 18


Level 4
8 x 8
9 9 9 9 9 9 9 9
6 9 9 9 9 9 9 9
9 9 9 9 9 4 9 9
0 9 7 9 7 9 7 9
9 9 9 9 9 9 9 1
9 8 9 4 9 9 8 4
9 9 6 9 9 9 6 9
9 9 9 9 9 9 9 9

ideal 8, max 10


Level 5
8 x 8
9 6 9 9 2 3 5 9
9 9 9 6 9 3 9 9
9 0 9 9 4 3 2 6
9 9 4 2 9 9 5 9
9 9 5 4 9 3 9 9
9 2 9 5 3 3 1 6
9 9 9 9 9 3 5 9
9 5 9 9 9 9 9 9

ideal 8, max 9

Level 6
10 x 10
9 6 9 9 9 9 9 9 9 9
9 9 4 9 4 4 9 9 9 9
9 0 9 4 9 9 9 9 9 6
9 6 9 9 9 9 9 9 9 9
9 9 9 9 9 6 9 9 9 9
9 6 9 9 9 9 9 9 9 9
9 9 9 4 4 4 4 9 9 9
9 9 9 4 9 9 9 6 9 4
9 9 4 9 9 9 9 9 6 1
9 9 9 9 9 9 9 6 9 4

ideal 15, max 18


Level 7
10 x 10
9 6 9 9 3 9 9 9 9 9
9 9 9 9 3 3 3 9 9 9
9 9 9 9 9 9 9 6 6 9
4 4 3 3 3 9 9 9 6 9
0 9 6 3 6 6 9 9 9 9
4 9 9 3 6 6 9 9 9 1
9 6 9 3 9 9 6 9 9 4
3 3 9 9 9 9 3 3 3 4
3 6 9 3 9 3 3 9 9 9
3 6 3 3 6 3 9 9 9 6

ideal 16, max 19


Level 8
10 x 10
9 9 6 9 4 9 0 4 9 9
9 9 6 9 9 9 3 3 3 9
9 9 4 6 6 7 3 3 6 9
4 9 9 3 3 3 3 4 9 4
4 8 3 3 9 9 4 9 9 9
9 9 3 7 9 7 9 7 9 4
4 9 9 9 6 6 9 9 9 9
9 9 6 3 3 3 3 3 3 9
9 9 9 3 3 6 3 4 8 4
9 9 9 6 6 1 9 9 4 4

ideal 23, max 26

Level 9
10 x 10
9 9 9 9 7 9 9 9 9 9
5 9 9 5 0 2 3 9 9 9
5 9 9 9 9 3 3 9 9 9
6 9 9 9 9 9 3 3 9 9
3 9 9 8 8 6 9 9 9 9
3 4 3 2 2 2 3 3 9 9
8 9 8 9 9 5 8 9 9 9
9 9 4 9 7 5 9 9 9 9
9 5 5 9 9 3 3 1 6 9
9 9 9 9 3 3 9 4 9 9

ideal 10, max 12

Level 10
10 x 10
5 5 9 9 6 4 8 9 9 9
2 0 9 7 5 9 9 9 9 9
3 3 3 6 6 5 9 9 9 2
2 6 3 3 3 3 9 9 9 2
9 9 4 9 9 3 7 9 9 9
5 9 9 5 5 9 9 4 3 9
3 3 9 2 3 3 3 3 3 9
2 3 9 7 5 9 4 9 6 9
9 3 3 3 9 9 8 5 9 9
6 9 6 9 7 9 4 9 1 9

ideal 20, max 22